11111111111111111111111111111111111
1110C0000C1C000001000C000001C0001E1
11101011001111110101111111C1C110101
111000C10C11111101C100C000011110101
11111111001111110101011111110000101
1000C000001111110101010C00010110101
1C1111011111100C0101C1000001011C101
101C110111111C010101011110110111101
1P1000C0000C000100010000C0000000001
11111111111111111111111111111111111